Title - Calamity OST - The Tale of a Cruel World
Mysterious Place - Space Fantasy - Super Mario Galaxy
Fierce Battle - Pokemon Black Elite Four
Distant Future - Оставить как есть, всё равно один раз за всю игру играет
Awakened - A Hat in Time - Clocktowers Beneath the Sea
Cargo Hold - Dreamy Mushrise Winds 
Battle 1 - Octopath Traveler - Battle I
M.S. Solar - Aspertia City 1.15.4419
Welcome to CrossWorlds - Ori & The Blind Forest - The Spirit Tree 
Challenge 1 - Final Destination (Delta Mix) 
Taking What Does Not Belong - Snatcher's Contractual Obligations
Boss Battle - Blooming Villain Persona 5: Scramble 1
CrossCounter! - Shovel Knight - The Rival (Black Knight - First Battle) 
Escape - Deltarune Chase 
Newcomer's Bridge - Pokemon Heart Gold - Route 29
Rhombus Dungeon - First Steps- Celeste 
Challenge 2 - Sonic Unleashed - vs. Titan & Big Mother
Emilie theme - Sonic Unleashed - Spagonia (Night)
Apollo Theme - Ace Attorney - Cornered 
Rookie Harbor - Gravity Rush OST - Downtown 
Autumn's Rise - Xenoblade Chronicles - Gaur Plains 
Battle 2 - Etrian Odyssey IV - Music: Battlefield - Storm
Travelling Together - Home - Undertale 
Lea! - Lillie’s Theme Pokemon - Sun & Moon
Bergen Trail - Pokemon Diamond & Pearl - Route 216 (Night)
Bergen Village - Final Fantasy 7 - Cosmo Canyon
Briefing - Cid's Theme - Final Fantasy 7
First Scholars - Poolside Rest - Mario Odyssey                                     
Temple Mine - TLOZelda Minish Cap Remaster Temple of Droplets 
Improvising - Life Goes On - Persona 5 
Maroon Valley - NieR Automata - Memories of Dust
Ba'kii Kum - Pokemon Black & White - Driftveil City
Shocking Reveal - Unsettling Atmosphere - Sun & Moon
Temple of the Valley - Tricky Maze - Sonic Adventure
Lucid Dream - Final Fantasy 7 - Chasing the Black-Caped Man
Autumn's Fall - The Legend of Zelda: Spirit Tracks - Realm Overworld
Raid - Battle Tower Theme - Pokemon Sword & Shield
The Expirience - Pokémon B2/W2 - Battle! Colress
Imprisoned - Final Fantasy VIII - Galbadia Garden 
Vermillion Wasteland - Antibirth OST - Drowning
Battle 3 - A Hat in Time - You Are All Bad Guys phase 
Confrontation - Final Fantasy 7 Remake - 7 Seconds till the End
Sadness - Pokemon Black - Unwavering Heart 
Infiltration, Stealth Side quest - Encounter Metal Gear Solid
Separated Again - Lifeformed - The Magnetic Tree (Fastfall - Dustforce OST)
Hack Your Way! - Sonic Colors - Terminal Velocity act 1
Escape Again - Final Fantasy 7 Remake - Hurry!
Exponential Growth - Undertale - Hopes & Dreams
Exponential Conclusion - Undertale - SAVE the World
Past Events - Valkyrie Profile 2 OST [Silmeria Side]
Gaia's Garden - NieR Automata - Forest Kingdom
Basin Keep - Celeste - Mirror Temple
Temple of the Lake - Chrono Cross OST - Chronopolis 
Temple of Thunder - Palace of Twilight - The Legend of Zelda: Twilight Princess
Temple of Grand Tree - The Legend of Zelda: Breath of The Wild - The Final Trial
Sapphire Ridge - Sonic Unleashed - Jungle Joyride (Night) 
Rhombus Square - Super Mario Odyssey - New Donk City
Old Hideout - Antibirth OST - Journey from a Jar to the Sky (Planetarium)
Shizuka - Touhou: Perfect Cherry Blossom - Border of Life 
True Intention - Gurren Lagann - What the Hell are You Thinking in the Dark!!
Infiltration - Final Fantasy 7 Remake - Bombing Mission
Vermillion Dungeon - Pokemon Sun & Moon - Ultra Megalopolis
The Ultimate Experience - Final Fantasy VI - Dancing Mad (Symphonic Arrange)
Ending - Ending Theme - Super Mario World 
Battle Arena - Pokémon World Tournament (PWT) - Pokémon Black2/White2
Boss Rush - Pokémon World Tournament Final Battle - Pokémon Black2/White2
S Rank - Kirby Planet Robobot - One Last Shot

Sephisloth Theme - Advent Children - One Winged Angel
Blue Hedgeheg - Sonic Mania - Metal Sonic
Peng Dakara - A Hat in Time - The Battle of Award 42
Sand Shark - Calamity OST - The Filthy Mind (featuring SixteenInMono)
Yellow Angler-Fish - Sonic Adventure - Chaos 6
PandzaMk.II - Super Mario Odyssey - RoboBrood Battle
DON'T USE THIS - Deltarune - The World Revolving (Sonic Advance Arr.)
ability got - item fanfare - Legend of Zelda: A Link Between Worlds
fanfare - obtained a gym badge - Pokemon X & Y
Dream - Final Fantasy 7 - Secrets Sleeping in the Deep Sea
muGlitch - NieR: Automata - Pascal (No Vocals)